SO   ./tex/poll.xpm
NO      ./tex/woll.xpm

WE         ./tex/loll.xpm

EA ./tex/pers_s.xpm
F                            222,25,108
C   126,20,25


    1111111111111 1111111111
    1000000000001 1000000001
    1000000000001 10000000011
    1000001111101 1101011111
111110100010000011100001
100000100010000100010001
100000100010000000000001
100000110110000101010001
100000000000000000000001
100000000000000000000001
100000000000000000000001
100000000000000000000001
100000000000000000000001
111111111000000000000001
1101    1000000000000001
1111    100N000000000001
110111111000000000000001
1101111110000000000000011
 110000000000000000000001
1111111110000000000000011
111111111111111111111111
