SO   ./tex/poll.xpm
NO      ./tex/woll.xpm

WE         ./tex/loll.xpm

EA ./tex/pers_s.xpm
F                            222,25,108
C   126,20,25


111111111111
100000111011
1010011 1111
1000001  101
1000N0111101
1101000000011
110010111111
1111111
